---+---+  |
   |   +--+
-+-+---|  |
 | +---+  |
-+-+---+--+
++-+---+--+
+----+----+
|    |     
+----+----+
+----|----+
-----+-----